0 0 0 1 0 0 2 2 0 4 0 0 0 4 0 0 2 0 0 0 0 4 0 0 0 0 0 4 0 0 0 3 3 0 2 0 0 0 4 0 0 0 0 0 3 3 3 2 0 0 0 0 0 0 0 0 0 0 4 0
0 0 0 0 1 0 0 2 0 0 0 3 3 0 0 0 0 0 0 0 0 0 1 3 3 3 3 3 0 2 0 0 0 0 0 0 0 0 0 0 0 0 0 0 2 0 0 0 0 0 0 3 3 0 0 4 0 0 0 0
4 0 3 3 3 3 3 3 3 2 0 0 4 2 0 0 0 0 1 0 0 0 0 0 0 2 0 0 0 0 0 3 3 0 2 0 0 0 0 0 0 3 3 3 3 3 3 3 3 0 0 0 0 2 0 0 4 0 0 0
0 0 0 4 0 4 0 0 4 2 3 3 3 3 0 0 0 4 0 0 2 3 3 3 3 3 3 3 3 0 0 0 0 0 0 0 0 0 0 0 0 0 0 0 0 0 0 0 0 3 3 3 3 0 0 0 4 0 0 0
0 3 3 3 3 3 3 3 0 0 0 0 0 0 0 0 0 0 0 0 2 0 0 0 0 0 0 0 3 0 3 3 3 3 0 0 0 0 0 0 0 3 3 3 3 3 3 3 3 3 0 0 0 0 0 0 0 0 0 0
0 0 0 4 0 0 0 0 0 3 3 3 3 0 0 0 0 0 0 0 1 0 3 3 3 3 3 3 3 3 0 0 0 0 0 0 0 0 0 0 0 1 0 0 0 0 0 0 0 3 3 3 3 0 3 0 0 0 0 2
0 0 5 1 5 0 0 3 3 3 3 0 0 0 2 0 0 4 0 0 0 0 0 0 2 0 0 0 0 0 3 3 3 0 0 0 0 0 0 0 0 5 0 0 0 0 0 0 3 3 3 0 0 0 2 1 0 0 0 0
0 4 5 0 0 0 0 0 0 3 3 3 3 3 0 5 0 2 0 0 0 0 0 0 0 0 4 0 3 3 3 3 0 0 0 4 0 2 0 0 0 5 4 0 5 5 2 3 0 0 3 3 3 0 0 0 3 0 0 0
5 5 0 0 0 0 0 0 0 3 3 3 3 0 0 0 0 0 0 4 0 0 0 0 0 0 2 0 0 0 3 3 3 0 0 0 0 0 0 0 0 4 0 0 0 5 0 0 0 0 0 3 3 3 0 0 0 0 0 2
0 0 0 0 0 0 0 0 0 2 3 3 3 0 0 0 0 0 0 4 0 0 0 0 0 0 2 0 5 4 3 3 3 3 0 5 0 0 0 0 0 0 0 4 0 0 4 5 0 0 3 3 3 0 0 0 0 4 2 0
0 0 0 4 5 0 0 0 0 0 0 3 3 0 0 0 0 2 0 0 0 0 0 0 0 0 5 4 0 5 3 3 3 0 0 0 0 0 2 2 0 0 0 5 4 0 5 5 2 2 2 3 3 4 0 5 0 4 0 0
4 2 2 0 0 0 0 0 0 0 3 3 3 0 0 0 0 0 0 0 0 4 0 0 0 0 0 0 2 0 0 3 3 0 0 4 0 0 0 0 0 0 2 2 0 4 0 0 0 3 3 3 3 0 0 0 0 4 5 0
0 2 0 0 0 0 0 0 0 0 4 3 3 0 0 0 0 0 0 0 0 0 2 2 0 0 0 0 0 3 3 3 3 3 4 0 0 0 0 0 0 0 0 0 0 4 0 0 0 4 3 3 3 0 0 0 0 0 0 0
0 0 0 4 0 0 0 0 0 3 3 3 3 3 0 0 0 0 2 2 0 0 0 0 0 0 0 0 3 3 3 3 0 0 0 0 0 0 0 0 0 0 0 0 0 3 3 3 3 3 3 3 3 3 0 0 0 0 4 0
0 4 2 2 0 0 0 3 3 3 3 0 4 0 0 5 0 2 4 0 3 3 3 3 3 3 3 3 3 3 3 3 3 3 0 0 0 0 0 0 0 0 0 2 2 3 3 3 3 3 3 0 0 0 5 0 0 0 0 3
3 3 3 3 3 3 3 3 3 3 3 3 3 0 0 0 0 4 0 0 0 0 0 2 3 3 3 3 3 0 0 0 0 0 0 0 0 0 3 3 3 3 3 3 3 3 3 0 0 0 0 0 0 0 0 0 2 0 0 0
0 0 3 3 3 3 3 3 3 0 0 0 0 3 3 3 3 3 3 3 3 3 0 0 3 3 3 0 0 0 0 0 0 0 0 0 0 0 0 0 3 3 3 3 3 3 3 3 3 3 3 3 3 3 3 3 3 3 3 3
0 0 0 0 0 0 0 0 0 0 0 0 0 4 0 0 0 0 0 2 3 3 3 3 3 3 3 3 3 3 3 3 3 3 3 3 3 3 3 3 5 0 0 0 0 0 0 0 0 0 2 0 0 0 0 0 0 0 0 0
3 3 3 3 3 3 3 3 3 3 3 3 0 0 0 0 0 5 0 0 0 0 0 0 0 0 0 0 0 0 2 0 0 0 0 0 0 0 0 0 0 3 3 3 3 3 0 2 0 0 0 0 0 0 2 0 0 0 0 0
0 0 4 0 0 4 0 0 0 0 0 4 0 0 0 0 0 0 0 0 0 0 3 3 3 0 0 4 0 0 0 0 0 0 0 0 5 5 0 0 0 0 0 0 0 0 0 0 0 0 0 0 0 0 0 0 0 0 0 0
0 0 0 0 0 0 0 0 0 0 0 0 0 0 0 0 0 0 0 0 0 0 0 0 0 0 0 0 0 0 0 0 0 0 0 0 0 0 0 0 0 0 0 0 0 0 0 0 0 0 0 0 0 0 0 0 0 0 0 0
0 0 0 0 0 0 0 0 0 0 0 0 0 0 0 0 0 0 0 0 0 0 0 0 0 0 0 0 0 0 0 0 0 0 0 0 0 0 0 0 0 0 0 0 0 0 0 0 0 0 0 0 0 0 0 0 0 0 0 0
0 0 0 0 0 0 0 0 0 0 0 0 0 0 0 0 0 0 0 0 0 0 0 0 0 0 0 0 0 0 0 0 0 0 0 0 0 0 0 0 0 0 0 0 0 0 0 0 0 0 0 0 0 0 0 0 0 0 0 0
0 0 0 0 0 0 0 0 0 0 0 0 0 0 0 0 0 0 0 0 0 0 0 0 0 0 0 0 0 0 0 0 0 0 0 0 0 0 0 0 0 0 0 0 0 0 0 0 0 0 0 0 0 0 0 0 0 0 0 0
0 0 0 0 0 0 0 0 0 0 0 0 0 0 0 0 0 0 0 0 0 0 0 0 0 0 0 0 0 0 0 0 0 0 0 0 0 0 0 0 0 0 0 0 0 0 0 0 0 0 0 0 0 0 0 0 0 0 0 0
0 0 0 0 0 0 0 0 0 0 0 0 0 0 0 0 0 0 0 0 0 0 0 0 0 0 0 0 0 0 0 0 0 0 0 0 0 0 0 0 0 0 0 0 0 0 0 0 0 0 0 0 0 0 0 0 0 0 0 0
0 0 0 0 0 0 0 0 0 0 0 0 0 0 0 0 0 0 0 0 0 0 0 0 0 0 0 0 0 0 0 0 0 0 0 0 0 0 0 0 0 0 0 0 0 0 0 0 0 0 0 0 0 0 0 0 0 0 0 0
0 0 0 0 0 0 0 0 0 0 0 0 0 0 0 0 0 0 0 0 0 0 0 0 0 0 0 0 0 0 0 0 0 0 0 0 0 0 0 0 0 0 0 0 0 0 0 0 0 0 0 0 0 0 0 0 0 0 0 0
0 0 0 0 0 0 0 0 0 0 0 0 0 0 0 0 0 0 0 0 0 0 0 0 0 0 0 0 0 0 0 0 0 0 0 0 0 0 0 0 0 0 0 0 0 0 0 0 0 0 0 0 0 0 0 0 0 0 0 0
0 0 0 0 0 0 0 0 0 0 0 0 0 0 0 0 0 0 0 0 0 0 0 0 0 0 0 0 0 0 0 0 0 0 0 0 0 0 0 0 0 0 0 0 0 0 0 0 0 0 0 0 0 0 0 0 0 0 0 0
0 0 0 0 0 0 0 0 0 0 0 0 0 0 0 0 0 0 0 0 0 0 0 0 0 0 0 0 0 0 0 0 0 0 0 0 0 0 0 0 0 0 0 0 0 0 0 0 0 0 0 0 0 0 0 0 0 0 0 0
0 0 0 0 0 0 0 0 0 0 0 0 0 0 0 0 0 0 0 0 0 0 0 0 0 0 0 0 0 0 0 0 0 0 0 0 0 0 0 0 0 0 0 0 0 0 0 0 0 0 0 0 0 0 0 0 0 0 0 0
0 0 0 0 0 0 0 0 0 0 0 0 0 0 0 0 0 0 0 0 0 0 0 0 0 0 0 0 0 0 0 0 0 0 0 0 0 0 0 0 0 0 0 0 0 0 0 0 0 0 0 0 0 0 0 0 0 0 0 0
0 0 0 0 0 0 0 0 0 0 0 0 0 0 0 0 0 0 0 0 0 0 0 0 0 0 0 0 0 0 0 0 0 0 0 0 0 0 0 0 0 0 0 0 0 0 0 0 0 0 0 0 0 0 0 0 0 0 0 0
0 0 0 0 0 0 0 0 0 0 0 0 0 0 0 0 0 0 0 0 0 0 0 0 0 0 0 0 0 0 0 0 0 0 0 0 0 0 0 0 0 0 0 0 0 0 0 0 0 0 0 0 0 0 0 0 0 0 0 0
0 0 0 0 0 0 0 0 0 0 0 0 0 0 0 0 0 0 0 0 0 0 0 0 0 0 0 0 0 0 0 0 0 0 0 0 0 0 0 0 0 0 0 0 0 0 0 0 0 0 0 0 0 0 0 0 0 0 0 0
0 0 0 0 0 0 0 0 0 0 0 0 0 0 0 0 0 0 0 0 0 0 0 0 0 0 0 0 0 0 0 0 0 0 0 0 0 0 0 0 0 0 0 0 0 0 0 0 0 0 0 0 0 0 0 0 0 0 0 0
0 0 0 0 0 0 0 0 0 0 0 0 0 0 0 0 0 0 0 0 0 0 0 0 0 0 0 0 0 0 0 0 0 0 0 0 0 0 0 0 0 0 0 0 0 0 0 0 0 0 0 0 0 0 0 0 0 0 0 0
0 0 0 0 0 0 0 0 0 0 0 0 0 0 0 0 0 0 0 0 0 0 0 0 0 0 0 0 0 0 0 0 0 0 0 0 0 0 0 0 0 0 0 0 0 0 0 0 0 0 0 0 0 0 0 0 0 0 0 0
0 0 0 0 0 0 0 0 0 0 0 0 0 0 0 0 0 0 0 0 0 0 0 0 0 0 0 0 0 0 0 0 0 0 0 0 0 0 0 0 0 0 0 0 0 0 0 0 0 0 0 0 0 0 0 0 0 0 0 0